1111111111111111111111111111111111
1C10000100000000010000100001000001
1000010111111001010000111011000011
1011110100001001010000001110001001
1000010100001100011101100010011001
1011110001000000010001000011110001
1010000101111111110C01001000100011
10111001C0000000010001011000101001
101000011111111101101101C011101001
1010100000000001001010010010001111
101111110001000100101011E010000001
100C000111110101000010011111110101
1000100100010101C11111111000000001
1111100110010101110000000001001001
1P00000000000100000110001001001001
1111111111111111111111111111111111
