1111111111111
10010000000c1
1000011111001
1p0011e000001
1111111111111
