111111
1001E1
100111
100001
1P00C1
111111
