111111
1000E1
100001
100111
1P01C1
111111
